wrist - rɪst
cultivate - ˈkʌltɪveɪt
catchy - ˈkætʃi
compose - kəmˈpəʊz
enormous - ɪˈnɔːməs
intrigued - ɪnˈtriːɡd
investigate - ɪnˈvestɪɡeɪt
jealous - ˈdʒeləs
realize - ˈriːəlaɪz
revise - rɪˈvaɪz
nixed - None
folks - None
lousy - ˈlaʊzi
particular - pəˈtɪkjələ(r)
possession - pəˈzeʃn
act - ækt
adjust - əˈdʒʌst
canvas - ˈkænvəs
chalk - tʃɔːk
cloth - klɒθ
kettle - ˈketl
nail - Noneɪl
needle - ˈniːdl
receipt - rɪˈsiːt
sail - seɪl
screw - skruː
thread - θred
throat - θrəʊt
thumb - θʌm
hook - hʊk
horn - hɔːn
pipe - paɪp
plate - pleɪt
plow - plaʊ
stem - stem
spade - speɪd
sponge - spʌndʒ
pot - pɒt
tray - treɪ
pump - pʌmp
whip - wɪp
account - əˈkaʊnt
committee - kəˈmɪti
degree - dɪˈɡriː
desire - dɪˈzaɪə(r)
amount - əˈmaʊnt
amusement - əˈmjuːzmənt
approval - əˈpruːvl
apparatus - ˌæpəˈreɪtəs
attraction - əˈtrækʃn
authority - ɔːˈθɒrəti
brass - brɑːs
burst - bɜːst
comparison - kəmˈpærɪsn
cork - kɔːk
cough - kɒf
curve - kɜːv
distribution - ˌdɪstrɪˈbjuːʃn
doubt - daʊt
debt - det
digestion - daɪˈdʒestʃən
expansion - ɪkˈspænʃn
harbor - None
measure - ˈmeʒə(r)
observation - ˌɒbzəˈveɪʃn
fold - fəʊld
grain - ɡreɪn
grip - ɡrɪp
firmly - ˈfɜːmli
insect - ˈɪnsekt
ink - ɪŋk
mind - maɪnd
mist - mɪst
insurance - ɪnˈʃʊərəns
linen - ˈlɪnɪn
liquid - ˈlɪkwɪd
ornament - ˈɔːnəmənt
excess - ɪkˈses
paste - peɪst
plant - plɑːnt
polish - ˈpɒlɪʃ
rate - reɪt
ray - reɪ
representative - ˌreprɪˈzentətɪv
rub - rʌb
scale - skeɪl
servant - ˈsɜːvənt
sign - saɪn
slip - slɪp
slope - sləʊp
smash - smæʃ
sneeze - sniːz
nap - næp
stage - steɪdʒ
statement - ˈsteɪtmənt
steam - stiːm
stitch - stɪtʃ
stretch - stretʃ
substance - ˈsʌbstəns
off - ɒf
on - ɒn
though - ðəʊ
chief - tʃiːf
fertile - ˈfɜːtaɪl
hang - hæŋ
past - pɑːst
acid - ˈæsɪd
fixed - fɪkst
conscious - ˈkɒnʃəs
equal - ˈiːkwəl
frequent - ˈfriːkwənt
hollow - ˈhɒləʊ
probable - ˈprɒbəbl
porter - ˈpɔːtə(r)
powder - ˈpaʊdə(r)
prose - prəʊz
tax - tæks
tin - tɪn
vessel - ˈvesl
redundant - rɪˈdʌndənt
twist - twɪst
thick - θɪk
violent - ˈvaɪələnt
responsible - rɪˈspɒnsəbl
stiff - stɪf
bitter - ˈbɪtə(r)
cruel - ˈkruːəl
delicate - ˈdelɪkət
feeble - ˈfiːbl
foolish - ˈfuːlɪʃ
loose - luːs
solid - ˈsɒlɪd
delicious - dɪˈlɪʃəs
abolish - əˈbɒlɪʃ
addiction - əˈdɪkʃn
amateur - ˈæmətə(r)
ambassador - æmˈbæsədə(r)
apron - ˈeɪprən
arrange - əˈreɪndʒ
arrogant - ˈærəɡənt
boast - bəʊst
canteen - kænˈtiːn
celebrity - səˈlebrəti
confidence - ˈkɒnfɪdəns
contribute - kənˈtrɪbjuːt
tribute - ˈtrɪbjuːt
correspondence - ˌkɒrəˈspɒndəns
craving - ˈkreɪvɪŋ
crawl - krɔːl
dedication - ˌdedɪˈkeɪʃn
dedicate - ˈdedɪkeɪt
descend - dɪˈsend
deteriorate - dɪˈtɪəriəreɪt
dismiss - dɪsˈmɪs
dissolve - dɪˈzɒlv
district - ˈdɪstrɪkt
elaborate - ɪˈlæbərət
embarrassment - ɪmˈbærəsmənt
emergency - ɪˈmɜːdʒənsi
entourage - ˈɒnturɑːʒ
evidence - ˈevɪdəns
extinction - ɪkˈstɪŋkʃn
famine - ˈfæmɪn
flood - flʌd
generosity - ˌdʒenəˈrɒsəti
gluttony - ˈɡlʌtəni
hiccup - ˈhɪkʌp
humiliate - hjuːˈmɪlieɪt
interpret - ɪnˈtɜːprət
maintain - meɪnˈteɪn
mature - məˈtʃʊə(r)
naughty - ˈnɔːti
persuade - pəˈsweɪd
clay - kleɪ
violation - ˌvaɪəˈleɪʃn
negotiate - nɪˈɡəʊʃieɪt
contrition - kənˈtrɪʃn
truly - ˈtruːli
attend - əˈtend
nasty - ˈnɑːsti
promotion - prəˈməʊʃn
prosecutor - ˈprɒsɪkjuːtə(r)
quarrel - ˈkwɒrəl
rapport - ræˈpɔː(r)
referee - ˌrefəˈriː
reference book - None
rehearsal - rɪˈhɜːsl
remarkable - rɪˈmɑːkəbl
resentment - rɪˈzentmənt
ruthless - ˈruːθləs
satchel - ˈsætʃəl
spokesman - ˈspəʊksmən
squeeze - skwiːz
stationary - ˈsteɪʃənri
sufficient - səˈfɪʃnt
superstition - ˌsuːpəˈstɪʃn
surveyor - səˈveɪə(r)
suspect - səˈspekt
vain - veɪn
valuable - ˈvæljuəbl
withdraw - wɪðˈdrɔː
obsession - əbˈseʃn
rust - rʌst
confess - kənˈfes
felony - ˈfeləni
circumstances - None
untenable - ʌnˈtenəbl
rattle - ˈrætl
mortgage - ˈmɔːɡɪdʒ
spank - spæŋk
offence - əˈfens
restroom - ˈrestruːm
make a sense - None
noble - ˈnəʊbl
impose - ɪmˈpəʊz
aware - əˈweə(r)
envy - ˈenvi
acquainted - əˈkweɪntɪd
witness - ˈwɪtnəs
mascot - ˈmæskət
capable - ˈkeɪpəbl
groom - ɡruːm
bride - braɪd
bargain - ˈbɑːɡən
douse - daʊs
compassion - kəmˈpæʃn
curious - ˈkjʊəriəs
decent - ˈdiːsnt
bugger - ˈbʌɡə(r)
embrace - ɪmˈbreɪs
spit it out - None
roam - rəʊm
odd - ɒd
eternity - ɪˈtɜːnəti
renege - rɪˈniːɡ
steep - stiːp
torture - ˈtɔːtʃə(r)
abandon - əˈbændən
parley - ˈpɑːli
oblivion - əˈblɪviən
lately - ˈleɪtli
abasement - əˈbeɪsmənt
abhor - əbˈhɔː(r)
abrasive - əˈbreɪsɪv
absolution - ˌæbsəˈluːʃn
abstain - əbˈsteɪn
abstemious - əbˈstiːmiəs
affinity - əˈfɪnəti
affliction - əˈflɪkʃn
relent - rɪˈlent
avert - əˈvɜːt
shatter - ˈʃætə(r)
glimmer - ˈɡlɪmə(r)
affluent - ˈæfluənt
alacrity - əˈlækrəti
excitement - ɪkˈsaɪtmənt
envelope - ˈenvələʊp
fir tree - None
dandelion - ˈdændɪlaɪən
ham - hæm
alleviate - əˈliːvieɪt
ambiguous - æmˈbɪɡjuəs
animosity - ˌænɪˈmɒsəti
spot - spɒt
demand - dɪˈmɑːnd
whiskers - None
handkerchief - ˈhæŋkətʃɪf
waist - weɪst
dining - ˈdaɪnɪŋ
properly - ˈprɒpəli
deaf - def
be around - None
louse - laʊs
brusque - bruːsk
capricious - kəˈprɪʃəs
charisma - kəˈrɪzmə
upset - ˌʌpˈset
boldness - ˈbəʊldnəs
complicity - kəmˈplɪsəti
comprehensive - ˌkɒmprɪˈhensɪv
concoct - kənˈkɒkt
counterfeit - ˈkaʊntəfɪt
covert - ˈkʌvət
start for - None
pour - pɔː(r)
cellar - ˈselə(r)
gust - ɡʌst
remembering - None
shave - ʃeɪv
resign - rɪˈzaɪn
reckless - ˈrekləs
foil - fɔɪl
insult - ˈɪnsʌlt
bigot - ˈbɪɡət
sight - saɪt
pile - paɪl
bilk - bɪlk
billow - ˈbɪləʊ
beg - beɡ
purse - pɜːs
gleam - ɡliːm
sober - ˈsəʊbə(r)
tremble - ˈtrembl
broth - brɒθ
upside down - None
to faint - None
cower - ˈkaʊə(r)
will - wɪl
I wonder - None
afford - əˈfɔːd
distraction - dɪˈstrækʃn
violate - ˈvaɪəleɪt
scuff - skʌf
creditable - ˈkredɪtəbl
cringe - krɪndʒ
cryptic - ˈkrɪptɪk
deceive - dɪˈsiːv
deception - dɪˈsepʃn
peel - piːl
dizzy - ˈdɪzi
no clue - None
consistent - kənˈsɪstənt
talon - ˈtælən
funky - ˈfʌŋki
chew - tʃuː
charming - ˈtʃɑːmɪŋ
robust - rəʊˈbʌst
ditch - dɪtʃ
burden - ˈbɜːdn
loony - ˈluːni
catch up - None
engage - ɪnˈɡeɪdʒ
occasion - əˈkeɪʒn
seal - siːl
foretell - fɔːˈtel
errand - ˈerənd
villainy - ˈvɪləni
treason - ˈtriːzn
impale - ɪmˈpeɪl
swirling - None
dubious - ˈdjuːbiəs
sorcery - ˈsɔːsəri
heels - None
sprightly - ˈspraɪtli
filthy - ˈfɪlθi
maim - meɪm
attain - əˈteɪn
quench - kwentʃ
anxious - ˈæŋkʃəs
I fancy - None
giddiness - ˈɡɪdinəs
cherish - ˈtʃerɪʃ
behold - bɪˈhəʊld
startle - ˈstɑːtl
intentionally - ɪnˈtenʃənəli
encounter - ɪnˈkaʊntə(r)
foreign currency - None
epiphany - ɪˈpɪfəni
shy - ʃaɪ
lure - lʊə(r)
demise - dɪˈmaɪz
blend - blend
decay - dɪˈkeɪ
expel - ɪkˈspel
fickle - ˈfɪkl
possess - pəˈzes
predisposition - ˌpriːdɪspəˈzɪʃn
detention - dɪˈtenʃn
wit - wɪt
fascinating - ˈfæsɪneɪtɪŋ
grasp - ɡrɑːsp
menace - ˈmenəs
rebellion - rɪˈbeljən
prod - prɒd
persistence - pəˈsɪstəns
banish - ˈbænɪʃ
dimple - ˈdɪmpl
ancestors - None
pester - ˈpestə(r)
contest - ˈkɒntest
imply - ɪmˈplaɪ
tip - tɪp
immediately - ɪˈmiːdiətli
humid - ˈhjuːmɪd
midget - ˈmɪdʒɪt
yell - jel
inception - ɪnˈsepʃn
conjure - ˈkʌndʒə(r)
vicious - ˈvɪʃəs
fraud - frɔːd
innocent - ˈɪnəsnt
haste - heɪst
chores - None
prosperity - prɒˈsperəti
revelation - ˌrevəˈleɪʃn
consequence - ˈkɒnsɪkwəns
remedy - ˈremədi
boar - bɔː(r)
intimidate - ɪnˈtɪmɪdeɪt
haunt - hɔːnt
avalanche - ˈævəlɑːnʃ
treacherous - ˈtretʃərəs
sane - seɪn
fornicate - ˈfɔːnɪkeɪt
wicked - ˈwɪkɪd
abduct - æbˈdʌkt
partake - pɑːˈteɪk
bona_fide - None
consider - kənˈsɪdə(r)
wack - wæk
eviction - ɪˈvɪkʃn
stroll - strəʊl
affair - əˈfeə(r)
propose - prəˈpəʊz
merely - ˈmɪəli
wrap - ræp
contenders - None
couch - kaʊtʃ
stove - stəʊv
serenity - səˈrenəti
dork - dɔːk
apparently - əˈpærəntli
renovation - ˌrenəˈveɪʃn
feign - feɪn
vigilant - ˈvɪdʒɪlənt
cubs - None
obey - əˈbeɪ
deliberately - dɪˈlɪbərətli
jeopardize - ˈdʒepədaɪz
meticulous - məˈtɪkjələs
endure - ɪnˈdjʊə(r)
ferocious - fəˈrəʊʃəs
bleak - bliːk
frolic - ˈfrɒlɪk
evenly - ˈiːvnli
sin - sɪn
legit - lɪˈdʒɪt
conform - kənˈfɔːm
lush - lʌʃ
fidget - ˈfɪdʒɪt
elusive - ɪˈluːsɪv
inevitable - ɪnˈevɪtəbl
exhausted - ɪɡˈzɔːstɪd
sweep - swiːp
seduce - sɪˈdjuːs
malware - ˈmælweə(r)
flaw - flɔː
sobbing - None
neat - niːt
fugitive - ˈfjuːdʒətɪv
commitment - kəˈmɪtmənt
obtain - əbˈteɪn
caveat - ˈkæviæt
sore - sɔː(r)
desperate - ˈdespərət
gullible - ˈɡʌləbl
peek - piːk
devastating - ˈdevəsteɪtɪŋ
complicit - kəmˈplɪsɪt
implicit - ɪmˈplɪsɪt
explicit - ɪkˈsplɪsɪt
gently - ˈdʒentli
mishap - ˈmɪshæp
prophet - ˈprɒfɪt
hasty - ˈheɪsti
preoccupied - priˈɒkjupaɪd
bruise - bruːz
enchanted - ɪnˈtʃɑːntɪd
tidings - ˈtaɪdɪŋz
my condolences - None
courtesy - ˈkɜːtəsi
interfere - ˌɪntəˈfɪə(r)
mock - mɒk
precise - prɪˈsaɪs
virtuous - ˈvɜːtʃuəs
prudence - ˈpruːdns
disruption - dɪsˈrʌpʃn
contaminate - kənˈtæmɪneɪt
get along - None
gossipy - ˈɡɒsɪpi
capacity - kəˈpæsəti
insane - ɪnˈseɪn
threshold - ˈθreʃhəʊld
vulnerability - ˌvʌlnərəˈbɪləti
vast - vɑːst
assignment - əˈsaɪnmənt
intertwine - ˌɪntəˈtwaɪn
nod - nɒd
delight - dɪˈlaɪt
enlighten - ɪnˈlaɪtn
substitute - ˈsʌbstɪtjuːt
nausea - ˈnɔːziə
worship - ˈwɜːʃɪp
severe - sɪˈvɪə(r)
preach - priːtʃ
considerate - kənˈsɪdərət
exhilarate - ɪɡˈzɪləreɪt
obnoxious - əbˈnɒkʃəs
mischief - ˈmɪstʃɪf
venture - ˈventʃə(r)
lucrative - ˈluːkrətɪv
tailor - ˈteɪlə(r)
sincerity - sɪnˈserəti
diligent - ˈdɪlɪdʒənt
grief - ɡriːf
resolve - rɪˈzɒlv
condemn - kənˈdem
devotion - dɪˈvəʊʃn
avail - əˈveɪl
delicacy - ˈdelɪkəsi
rambunctious - ræmˈbʌŋkʃəs
acumen - ˈækjəmən
willing - ˈwɪlɪŋ
truce - truːs
splendid - ˈsplendɪd
stalk - stɔːk
accompany - əˈkʌmpəni
inferior - ɪnˈfɪəriə(r)
assault - əˈsɔːlt
steer - stɪə(r)
entity - ˈentəti
sophisticated - səˈfɪstɪkeɪtɪd
repent - rɪˈpent
quaint - kweɪnt
pry - praɪ
essentially - ɪˈsenʃəli
adversary - ˈædvəsəri
mitigate - ˈmɪtɪɡeɪt
stork - stɔːk
shindig - ˈʃɪndɪɡ
cuss - kʌs
modest - ˈmɒdɪst
cohabitant - None
cohabit - kəʊˈhæbɪt
perv - pɜːv
evasive - ɪˈveɪsɪv
unease - ʌnˈiːz
profound - prəˈfaʊnd
overwhelmed - None
behoove - None
inbound - ˈɪnbaʊnd
outbound - ˈaʊtbaʊnd
interception - ˌɪntəˈsepʃn
accustomed - əˈkʌstəmd
hood - hʊd
pace - peɪs
efficient - ɪˈfɪʃnt
harassment - ˈhærəsmənt
clarify - ˈklærəfaɪ
haystack - ˈheɪstæk
perceptive - pəˈseptɪv
observe - əbˈzɜːv
aptitude - ˈæptɪtjuːd
hence - hens
fallacy - ˈfæləsi
ponder - ˈpɒndə(r)
testament - ˈtestəmənt
porcupine - ˈpɔːkjupaɪn
pedestrian - pəˈdestriən
crate - kreɪt
blurry - ˈblɜːri
squint - skwɪnt
infestation - ˌɪnfeˈsteɪʃn
postpone - pəˈspəʊn
uncanny - ʌnˈkæni
docile - ˈdəʊsaɪl
tenacious - təˈneɪʃəs
ambiance - None
perplexed - pəˈplekst
masseuse - mæˈsɜːz
narrate - nəˈreɪt
kidnap - ˈkɪdnæp
perturbation - ˌpɜːtəˈbeɪʃn
accomplished - əˈkʌmplɪʃt
equity - ˈekwəti
ennui - ɒnˈwiː
covenant - ˈkʌvənənt
dicey - ˈdaɪsi
in lieu of - None
notch - nɒtʃ
cant put my finger on you - None
attorney - əˈtɜːni
stand by - None
grifter - ˈɡrɪftə(r)
ordinance - ˈɔːdɪnəns
overhaul - ˈəʊvəhɔːl
prowler - ˈpraʊlə(r)
heap - hiːp
coy - kɔɪ
camcorder - ˈkæmkɔːdə(r)
incorrigible - ɪnˈkɒrɪdʒəbl
soaring - None
concise - kənˈsaɪs
gory - ˈɡɔːri
standoff - None
cleanse - klenz
count on me - None
stumble - ˈstʌmbl
con man - None
boisterous - ˈbɔɪstərəs
disgruntled - dɪsˈɡrʌntld
pledge - pledʒ
wind up - None
malnourished - ˌmælˈnʌrɪʃt
ransom - ˈrænsəm
giddy - ˈɡɪdi
mercifully - ˈmɜːsɪfəli
selfish - ˈselfɪʃ
chuffed - tʃʌft
embittered - ɪmˈbɪtəd
ribbon - ˈrɪbən
sustenance - ˈsʌstənəns
famished - ˈfæmɪʃt
snug - snʌɡ
mend - mend
despondent - dɪˈspɒndənt
lavatory - ˈlævətri
fractious - ˈfrækʃəs
battered - ˈbætəd
swarm - swɔːm
massacre - ˈmæsəkə(r)
puncture - ˈpʌŋktʃə(r)
dignified - ˈdɪɡnɪfaɪd
fragile - ˈfrædʒaɪl
dull - dʌl
sombre - ˈsɒmbə(r)
mesmerizing - ˈmezməraɪzɪŋ
stagger - ˈstæɡə(r)
wobbly - ˈwɒbli
primordial - praɪˈmɔːdiəl
halt - hɔːlt
appalling - əˈpɔːlɪŋ
perilous - ˈperələs
tide - taɪd
wuss - wʊs
poke - pəʊk
drizzle - ˈdrɪzl
obtuse - əbˈtjuːs
nimble - ˈnɪmbl
friction - ˈfrɪkʃn
ruminate - ˈruːmɪneɪt
frankly - ˈfræŋkli
reluctantly - rɪˈlʌktəntli
fuss - fʌs
ludicrously - ˈluːdɪkrəsli
exquisite - ɪkˈskwɪzɪt
succulent - ˈsʌkjələnt
agenda - əˈdʒendə
mediocre - ˌmiːdiˈəʊkə(r)
fraternity - frəˈtɜːnəti
flunk - flʌŋk
precaution - prɪˈkɔːʃn
wager - ˈweɪdʒə(r)
so long - None
holler - ˈhɒlə(r)
content - None
condescending - ˌkɒndɪˈsendɪŋ
consent - kənˈsent
inept - ɪˈnept
vaguely - ˈveɪɡli
traitor - ˈtreɪtə(r)
in charge - None
lunkhead - ˈlʌŋkhed
depict - dɪˈpɪkt
dignity - ˈdɪɡnəti
sobriquet - ˈsəʊbrɪkeɪ
vomit - ˈvɒmɪt
concede - kənˈsiːd
nigh - naɪ
deduce - dɪˈdjuːs
in vain - None
potent - ˈpəʊtnt
calamity - kəˈlæməti
fortify - ˈfɔːtɪfaɪ
verge - vɜːdʒ
torment - ˈtɔːment
behalf of - None
rascal - ˈrɑːskl
deceit - dɪˈsiːt
blur - blɜː(r)
cuddly - ˈkʌdli
pep - pep
jolt - dʒəʊlt
intervention - ˌɪntəˈvenʃn
bozo - ˈbəʊzəʊ
fluke - fluːk
slumber - ˈslʌmbə(r)
cater - ˈkeɪtə(r)
hoodlum - ˈhuːdləm
parch - pɑːtʃ
maternity - məˈtɜːnəti
controversy - ˈkɒntrəvɜːsi
ominous - ˈɒmɪnəs
vile - vaɪl
seam - siːm
surpass - səˈpɑːs
adverse - ˈædvɜːs
swerve - swɜːv
coherent - kəʊˈhɪərənt
seedy - ˈsiːdi
i regard - None
ostentatious - ˌɒstenˈteɪʃəs
notorious - nəʊˈtɔːriəs
deplore - dɪˈplɔː(r)
although - ɔːlˈðəʊ
judicious - dʒuˈdɪʃəs
harsh - hɑːʃ
subtle - ˈsʌtl
scavenger - ˈskævɪndʒə(r)
implement - ˈɪmplɪment
comply - kəmˈplaɪ
appall - None
travesty - ˈtrævəsti
pavement - ˈpeɪvmənt
vicinity - vəˈsɪnəti
cozy - ˈkəʊzi
sturdy - ˈstɜːdi
fetch - fetʃ
whine - waɪn
tantrum - ˈtæntrəm
bleach - bliːtʃ
amity - ˈæməti
suffocate - ˈsʌfəkeɪt
suppress - səˈpres
obliterate - əˈblɪtəreɪt
strap down - None
crucial - ˈkruːʃl
discretion - dɪˈskreʃn
favorable - None
habitat - ˈhæbɪtæt
notion - ˈnəʊʃn
commence - kəˈmens
expose - ɪkˈspəʊz
innocuous - ɪˈnɒkjuəs
burglar - ˈbɜːɡlə(r)
eradicate - ɪˈrædɪkeɪt
diverse - daɪˈvɜːs
arbitrary - ˈɑːbɪtrəri
whereas - ˌweərˈæz
infer - ɪnˈfɜː(r)
atrocious - əˈtrəʊʃəs
tally - ˈtæli
celestial - səˈlestiəl
deprecate - ˈdeprəkeɪt
heresy - ˈherəsi
fluffy - ˈflʌfi
complacent - kəmˈpleɪsnt
secluded - sɪˈkluːdɪd
equitable - ˈekwɪtəbl
restraint - rɪˈstreɪnt
guerilla war - None
heir - eə(r)
distinguish - dɪˈstɪŋɡwɪʃ
carnage - ˈkɑːnɪdʒ
induce - ɪnˈdjuːs
posture - ˈpɒstʃə(r)
fiddle - ˈfɪdl
perpetrator - ˈpɜːpətreɪtə(r)
bagel - ˈbeɪɡl
outrageous - aʊtˈreɪdʒəs
disdain - dɪsˈdeɪn
fiercely - ˈfɪəsli
vengeance - ˈvendʒəns
valiant - ˈvæliənt
rouse - raʊz
flee - fliː
reconcile - ˈrekənsaɪl
appeasre - None
flair - fleə(r)
bereavement - bɪˈriːvmənt
gloat - ɡləʊt
relentless - rɪˈlentləs
amends - əˈmendz
divert - daɪˈvɜːt
astonishing - əˈstɒnɪʃɪŋ
moisture - ˈmɔɪstʃə(r)
atrocity - əˈtrɒsəti
shirk - ʃɜːk
subpoena - səˈpiːnə
defer - dɪˈfɜː(r)
deprive - dɪˈpraɪv
overdue - ˌəʊvəˈdjuː
volatile - ˈvɒlətaɪl
solitude - ˈsɒlətjuːd
bliss - blɪs
proclaim - prəˈkleɪm
assertion - əˈsɜːʃn
refuge - ˈrefjuːdʒ
petal - ˈpetl
peculiar - pɪˈkjuːliə(r)
temper - ˈtempə(r)
refrain - rɪˈfreɪn
accuse - əˈkjuːz
accusation - ˌækjuˈzeɪʃn
effed up - None
vat - væt
clingy - None
imposter - None
exempt - ɪɡˈzempt
solace - ˈsɒləs
valor - None
glance - ɡlɑːns
penniless - ˈpeniləs
spree - spriː
formidable - fəˈmɪdəbl
commotion - kəˈməʊʃn
incoherent - ˌɪnkəʊˈhɪərənt
indulgent - ɪnˈdʌldʒənt
forge - fɔːdʒ
manor - ˈmænə(r)
jaw - dʒɔː
glimpse - ɡlɪmps
pollen - ˈpɒlən
buttocks - None
voluntarily - ˈvɒləntrəli
turds - None
nurture - ˈnɜːtʃə(r)
flock - flɒk
daunt - dɔːnt
conventional - kənˈvenʃənl
leisure - ˈleʒə(r)
strive - straɪv
recess - ˈriːses
mundanity - None
pristine - ˈprɪstiːn
dew - djuː
quivering - None
gossamer - ˈɡɒsəmə(r)
gown - ɡaʊn
tippet - ˈtɪpɪt
tulle - tjuːl
swelling - ˈswelɪŋ
scarcely - ˈskeəsli
cornice - ˈkɔːnɪs
mound - maʊnd
brink - brɪŋk
retribution - ˌretrɪˈbjuːʃn
obsolete - ˈɒbsəliːt
grimy - ˈɡraɪmi
deterrent - dɪˈterənt
predecessors - None
dismantle - dɪsˈmæntl
beset - bɪˈset
fossil - ˈfɒsl
ripple - ˈrɪpl
neglect - nɪˈɡlekt
fruition - fruˈɪʃn
goblet - ˈɡɒblət
salmon - ˈsæmən
layperson - ˈleɪpɜːsn
reimburse - ˌriːɪmˈbɜːs
hosed - None
drastically - ˈdræstɪkli
collision - kəˈlɪʒn
conduit - ˈkɒndjuɪt
simultaneously - ˌsɪmlˈteɪniəsli
dissecting - None
segregate - ˈseɡrɪɡeɪt
kidney - ˈkɪdni
knock up - None
goof - ɡuːf
gratis - ˈɡrætɪs
eavesdrop - ˈiːvzdrɒp
egress - ˈiːɡres
fraction - ˈfrækʃn
mesh - meʃ
enhanced - ɪnˈhɑːnst
unison - ˈjuːnɪsn
negligible - ˈneɡlɪdʒəbl
heuristic - hjʊəˈrɪstɪk
plumage - ˈpluːmɪdʒ
derive - dɪˈraɪv
stoop - stuːp
dissection - dɪˈsekʃn
instantiation - None
evaluate - ɪˈvæljueɪt
commerce - ˈkɒmɜːs
permutation - ˌpɜːmjuˈteɪʃn
unicity - None
immense - ɪˈmens
distinct - dɪˈstɪŋkt
plausibly - ˈplɔːzəbli
congestion - kənˈdʒestʃən
retain - rɪˈteɪn
dwindle - ˈdwɪndl
commodity - kəˈmɒdəti
span - spæn
demarcation - ˌdiːmɑːˈkeɪʃn
susceptible - səˈseptəbl
gibberish - ˈdʒɪbərɪʃ
forgery - ˈfɔːdʒəri
truncate - trʌŋˈkeɪt
comprise - kəmˈpraɪz
prowess - ˈpraʊəs
consecutive - kənˈsekjətɪv
newt - njuːt
indefatigable - ˌɪndɪˈfætɪɡəbl
peril - ˈperəl
temptation - tempˈteɪʃn
rejoice - rɪˈdʒɔɪs
gorge - ɡɔːdʒ
tamper - ˈtæmpə(r)
obscure - əbˈskjʊə(r)
sass - sæs
trot - trɒt
acute - əˈkjuːt
derivation - ˌderɪˈveɪʃn
biased - ˈbaɪəst
tweak - twiːk
acquaintance - əˈkweɪntəns
intuition - ˌɪntjuˈɪʃn
infant - ˈɪnfənt
leper - ˈlepə(r)
oppress - əˈpres
drain - dreɪn
prong - prɒŋ
manacles - None
crucifixion - ˌkruːsəˈfɪkʃn
haggle - ˈhæɡl
dim - dɪm
vow - vaʊ
disperse - dɪˈspɜːs
insightful - ɪnˈsaɪtfl
chimney - ˈtʃɪmni
enhance - ɪnˈhɑːns
persevere - ˌpɜːsəˈvɪə(r)
intractable - ɪnˈtræktəbl
compliance - kəmˈplaɪəns
fend - fend
convict - kənˈvɪkt
tenant - ˈtenənt
earthenware - ˈɜːθnweə(r)
furl - fɜːl
herring - ˈherɪŋ
immensity - ɪˈmensəti
evoke - ɪˈvəʊk
thrive - θraɪv
mingle - ˈmɪŋɡl
itinerary - aɪˈtɪnərəri
ridge - rɪdʒ
sparse - spɑːs
preside - prɪˈzaɪd
ordnance - ˈɔːdnəns
storey - ˈstɔːri
escrow - None
irritability - ˌɪrɪtəˈbɪləti
digest - daɪˈdʒest
feasible - ˈfiːzəbl
ledger - ˈledʒə(r)
mansion - ˈmænʃn
carve - kɑːv
brag - bræɡ
perch - pɜːtʃ
promenade - ˌprɒməˈnɑːd
incentive - ɪnˈsentɪv
delve - delv
penalize - ˈpiːnəlaɪz
prerequisite - ˌpriːˈrekwəzɪt
insolence - ˈɪnsələns
withhold - wɪðˈhəʊld
subvert - səbˈvɜːt
juncture - ˈdʒʌŋktʃə(r)
prominent - ˈprɒmɪnənt
incur - ɪnˈkɜː(r)
propagation - ˌprɒpəˈɡeɪʃn
obligatory - əˈblɪɡətri
nifty - ˈnɪfti
ark - ˈɑːk
destitute - ˈdestɪtjuːt
perpetual - pəˈpetʃuəl
eligible - ˈelɪdʒəbl
tradeoff - None
mediate - ˈmiːdieɪt
bid - None
amendment - əˈmendmənt
hallucinate - həˈluːsɪneɪt
amortize - əˈmɔːtaɪz
swindle - ˈswɪndl
bribery - ˈbraɪbəri
punitive - ˈpjuːnətɪv
defer - dɪˈfɜː(r)
conundrum - kəˈnʌndrəm
intermediary - ˌɪntəˈmiːdiəri
discretion - dɪˈskreʃn
puddle - ˈpʌdl
mint - mɪnt
compatible - kəmˈpætəbl
rendezvous - ˈrɒndɪvuː
niche - niːʃ
merit - ˈmerɪt
custody - ˈkʌstədi
eponymous - ɪˈpɒnɪməs
discontinuity - ˌdɪsˌkɒntɪˈnjuːəti
skew - skjuː
consolidation - kənˌsɒlɪˈdeɪʃn
coercion - kəʊˈɜːʃn
vigilante - ˌvɪdʒɪˈlænti
outsource - ˈaʊtsɔːs
do away - None
clairvoyance - kleəˈvɔɪəns
bloat - bləʊt
abundance - əˈbʌndəns
anticipate - ænˈtɪsɪpeɪt
forestall - fɔːˈstɔːl
endeavor - None
revivify - ˌriːˈvɪvɪfaɪ
pave - peɪv
alter - ˈɔːltə(r)
intimate - ˈɪntɪmət
unsought - None
plagiarism - None
marred - None
snobbishly - None
decency - ˈdiːsnsi
riotous - ˈraɪətəs
excursions - None
scorn - skɔːn
intricate - ˈɪntrɪkət
responsiveness - None
flabby - ˈflæbi
foul - faʊl
elation - ɪˈleɪʃn
hardboiled - None
confer - kənˈfɜː(r)
solemn - ˈsɒləm
epigram - ˈepɪɡræm
slender - ˈslendə(r)
hemisphere - ˈhemɪsfɪə(r)
barnyard - ˈbɑːnjɑːd
superficial - ˌsuːpəˈfɪʃl
sinister - ˈsɪnɪstə(r)
savor - None
anticlimax - ˌæntiˈklaɪmæks
wistfully - ˈwɪstfəli
drift - drɪft
supercilious - ˌsuːpəˈsɪliəs
swank - swæŋk
gruff - ɡrʌf
husky - ˈhʌski
paternal - pəˈtɜːnl
contempt - kənˈtempt
defiant - dɪˈfaɪənt
vista - ˈvɪstə
sweep - swiːp
abruptly - əˈbrʌptli
ajar - əˈdʒɑː(r)
rug - rʌɡ
buoyant - ˈbɔɪənt
murmur - ˈmɜːmə(r)
conscientious - ˌkɒnʃiˈenʃəs
otter - ˈɒtə(r)
compulsion - kəmˈpʌlʃn
desolate - ˈdesələt
deft - deft
stiff - stɪf
pantry - ˈpæntri
incredulously - ɪnˈkredʒələsli
wan - wɒn
reciprocal - rɪˈsɪprəkl
contemptuously - kənˈtemptʃuəsli
precedent - ˈpresɪdənt
radiant - ˈreɪdiənt
awe - ɔː
sheer - ʃɪə(r)
dread - dred
submerge - səbˈmɜːdʒ
fervent - ˈfɜːvənt
butler - ˈbʌtlə(r)
dusk - dʌsk
quicken - ˈkwɪkən
faintly - ˈfeɪntli
extemporize - ɪkˈstempəraɪz
subdue - səbˈdjuː
cease - siːs
nightingale - ˈnaɪtɪŋɡeɪl
shrill - ʃrɪl
twilight - ˈtwaɪlaɪt
wicker - ˈwɪkə(r)
settee - seˈtiː
vigil - ˈvɪdʒɪl
tangible - ˈtændʒəbl
sedative - ˈsedətɪv
ether - ˈiːθə(r)
smirk - smɜːk
soothing - ˈsuːðɪŋ
fling - flɪŋ
corroborate - kəˈrɒbəreɪt
libel - ˈlaɪbl
stale - steɪl
dimly - ˈdɪmli
creak - kriːk
fatten - ˈfætn
brood - bruːd
dismal - ˈdɪzməl
contiguous - kənˈtɪɡjuəs
sumptuous - ˈsʌmptʃuəs
surplus - ˈsɜːpləs
veil - veɪl
totter - ˈtɒtə(r)
ecstatically - ɪkˈstætɪkli
unobtrusively - ˌʌnəbˈtruːsɪvli
devoid - dɪˈvɔɪd
gayety - None
peremptorily - pəˈremptrəli
saunter - ˈsɔːntə(r)
jovially - ˈdʒəʊviəli
scrawny - ˈskrɔːni
resemblance - rɪˈzembləns
swung - swʌŋ
rapture - ˈræptʃə(r)
interpose - ˌɪntəˈpəʊz
regal - ˈriːɡl
pluck - plʌk
rakish - ˈreɪkɪʃ
incessant - ɪnˈsesnt
attire - əˈtaɪə(r)
rustle - ˈrʌsl
hauteur - əʊˈtɜː(r)
audibly - ˈɔːdəbli
strident - ˈstraɪdnt
deft - deft
clad - klæd
dexterity - dekˈsterəti
infallible - ɪnˈfæləbl
contraption - kənˈtræpʃn
muck - mʌk
scold - skəʊld
trowel - ˈtraʊəl
arouse - əˈraʊz
jury - ˈdʒʊəri
forfeit - None
welfare - ˈwelfeə(r)
taser - ˈteɪzə(r)
extortion - ɪkˈstɔːʃn
remorse - rɪˈmɔːs
pinnacle - ˈpɪnəkl
cantrip - None
chaste - tʃeɪst
tether - ˈteðə(r)
discrepancy - None
demeanor - None
stash - stæʃ
preliminary - prɪˈlɪmɪnəri
gaudy - ˈɡɔːdi
shorn - ʃɔːn
prodigality - ˌprɒdɪˈɡæləti
weave - wiːv
gypsy - ˈdʒɪpsi
hush - hʌʃ
obligingly - əˈblaɪdʒɪŋli
erroneous - ɪˈrəʊniəs
vehemently - ˈviːəməntli
credulity - krɪˈdjuːləti
testimony - ˈtestɪməni
homogeneity - ˌhəʊməʊdʒəˈniːəti
staid - steɪd
impetuously - ɪmˈpetʃuəsli
drip - drɪp
rowdy - ˈraʊdi
lull - lʌl
roughneck - ˈrʌfnek
florid - ˈflɒrɪd
corpulent - ˈkɔːpjələnt
wan - wɒn
coolly - ˈkuːlli
jauntiness - ˈdʒɔːntinəs
obstetrical - None
implore - ɪmˈplɔː(r)
ineptly - ɪˈneptli
rivulet - ˈrɪvjələt
vinous - None
asunder - əˈsʌndə(r)
dissension - dɪˈsenʃn
reluctance - rɪˈlʌktəns
deplorably - dɪˈplɔːrəbli
malevolence - məˈlevələns
tantalize - ˈtæntəlaɪz
jut - dʒʌt
discordant - None
din - dɪn
tangle - ˈtæŋɡl
fender - ˈfendə(r)
subterfuges - None
caddy - ˈkædi
poignant - ˈpɔɪnjənt
loiter - ˈlɔɪtə(r)
racy - ˈreɪsi
chasm - ˈkæzəm
endow - ɪnˈdaʊ
wafer - ˈweɪfə(r)
appartition - None
spanner - ˈspænə(r)
plough - plaʊ
bearing - ˈbeərɪŋ
meadow - ˈmedəʊ
smug - smʌɡ
damp - dæmp
fraught - frɔːt
defecate - ˈdefəkeɪt
achingly - ˈeɪkɪŋli
sophomore - ˈsɒfəmɔː(r)
dabble - ˈdæbl
immutable - ɪˈmjuːtəbl
culprit - ˈkʌlprɪt
apprehend - ˌæprɪˈhend
miscreant - ˈmɪskriənt
calamity - kəˈlæməti
baffling - ˈbæflɪŋ
intact - ɪnˈtækt
abomination - əˌbɒmɪˈneɪʃn
forensic - fəˈrenzɪk
saliva - səˈlaɪvə
binge - bɪndʒ
contention - kənˈtenʃn
utterly - ˈʌtəli
cocky - ˈkɒki
self-effacing - ˌself ɪˈfeɪsɪŋ
reticent - ˈretɪsnt
amenable - əˈmiːnəbl
latch - lætʃ
farce - fɑːs
hone - həʊn
cuddle - ˈkʌdl
distress flare - None
shrimp - ʃrɪmp
stifle - ˈstaɪfl
intolerable - ɪnˈtɒlərəbl
jaggedy - None
persecution - ˌpɜːsɪˈkjuːʃn
convene - kənˈviːn
astounded - əˈstaʊndɪd
affinity - əˈfɪnəti
spiteful - ˈspaɪtfl
obstacle - ˈɒbstəkl
trifle - ˈtraɪfl
rote - rəʊt
tease - tiːz
proficient - prəˈfɪʃnt
odour - ˈəʊdə(r)
peruse - pəˈruːz
frenzy - ˈfrenzi
resolute - ˈrezəluːt
infirmary - ɪnˈfɜːməri
mother lode - None
harness - ˈhɑːnɪs
chomp - tʃɒmp
abdomen - ˈæbdəmən
rake - reɪk
grudge - ɡrʌdʒ
trident - ˈtraɪdnt
reap - riːp
berk - bɜːk
rustic - ˈrʌstɪk
ample - ˈæmpl
ubiquitous - juːˈbɪkwɪtəs
fodder - ˈfɒdə(r)
adhere - ədˈhɪə(r)
maple - ˈmeɪpl
interrogation - ɪnˌterəˈɡeɪʃn
replenish - rɪˈplenɪʃ
blubber - ˈblʌbə(r)
designate - ˈdezɪɡneɪt
tightwad - ˈtaɪtwɒd
suave - swɑːv
crackpot - ˈkrækpɒt
whiff - wɪf
sprawl - sprɔːl
crude - kruːd
obstruct - əbˈstrʌkt
utterly - ˈʌtəli
fluctuate - ˈflʌktʃueɪt
stern - stɜːn
flancee - None
peculiarly - pɪˈkjuːliəli
disconcertion - None
elucit - None
consent - kənˈsent
girder - ˈɡɜːdə(r)
somber - None
juxtaposition - ˌdʒʌkstəpəˈzɪʃn
gratify - ˈɡrætɪfaɪ
benediction - ˌbenɪˈdɪkʃn
denizen - ˈdenɪzn
plaid - plæd
engross - ɪnˈɡrəʊs
beaux - bəʊz
shiver - ˈʃɪvə(r)
unfathomable - ʌnˈfæðəməbl
irregularity - ɪˌreɡjəˈlærəti
splendor - None
disembodied - ˌdɪsɪmˈbɒdid
glint - ɡlɪnt
fumble - ˈfʌmbl
gaudily - ˈɡɔːdɪli
soggy - ˈsɒɡi
harrow - ˈhærəʊ
streak - striːk
defunct - dɪˈfʌŋkt
mantelpiece - ˈmæntlpiːs
muster - ˈmʌstə(r)
amid - əˈmɪd
obstinate - ˈɒbstɪnət
vestige - ˈvestɪdʒ
confound - kənˈfaʊnd
exultation - ˌeɡzʌlˈteɪʃn
postern - None
hawthorn - ˈhɔːθɔːn
swath - None
intrud - None
labbergasted - None
nincompoop - ˈnɪŋkəmpuːp
duke - djuːk
grease - ɡriːs
impedance - ɪmˈpiːdns
rectification - ˌrektɪfɪˈkeɪʃn
repel - rɪˈpel
sorrow - ˈsɒrəʊ
razzle-dazzle - None
to clinch - None
swanky - ˈswæŋki
emphatic - ɪmˈfætɪk
exclaim - ɪkˈskleɪm
amplify - ˈæmplɪfaɪ
broom - bruːm
fringe activity - None
bogus - ˈbəʊɡəs
fringe - frɪndʒ
puny - ˈpjuːni
leash - liːʃ
discern - dɪˈsɜːn
clumsy - ˈklʌmzi
solace - ˈsɒləs
overwound - None
corrugate - None
scanty - ˈskænti
transpire - trænˈspaɪə(r)
shiftless - ˈʃɪftləs
meretricious - ˌmerəˈtrɪʃəs
ramification - ˌræmɪfɪˈkeɪʃn
lavish - ˈlævɪʃ
hitherto - ˌhɪðəˈtuː
tipsy - ˈtɪpsi
wisp - wɪsp
broil - brɔɪl
perspire - pəˈspaɪə(r)
affront - əˈfrʌnt
croone - None
abound - əˈbaʊnd
morbid - ˈmɔːbɪd
inexplicable - ˌɪnɪkˈsplɪkəbl
prolonged - prəˈlɒŋd
tumultuous - tjuːˈmʌltʃuəs
bead - biːd
vicariously - vɪˈkeəriəsli
sagely - ˈseɪdʒli
rancor - None
swindler - ˈswɪndlə(r)
lurch - lɜːtʃ
incessantly - ɪnˈsesntli
tumble - ˈtʌmbl
indiscernible - ˌɪndɪˈsɜːnəbl
pervade - pəˈveɪd
despise - dɪˈspaɪz
redolent - ˈredələnt
devot - None
sullen - ˈsʌlən
dangle - ˈdæŋɡl
brittle - ˈbrɪtl
feud - fjuːd
regarding - rɪˈɡɑːdɪŋ
thaw - θɔː
uppity - ˈʌpəti
dupe - djuːp
grin - ɡrɪn
grumpy - ˈɡrʌmpi
painstaking - ˈpeɪnzteɪkɪŋ
stride - straɪd
trivia - ˈtrɪviə
compartment - kəmˈpɑːtmənt
refute - rɪˈfjuːt
allege - əˈledʒ
pulley - ˈpʊli
upheaval - ʌpˈhiːvl
hermit - ˈhɜːmɪt
pesky - ˈpeski
homestead - ˈhəʊmsted
hoof - huːf
creek - kriːk
sturgeon - ˈstɜːdʒən
quibble over - None
inquisitive - ɪnˈkwɪzətɪv
wrangler - ˈræŋɡlə(r)
brag - bræɡ
depute - dɪˈpjuːt
legislator - ˈledʒɪsleɪtə(r)
knack - næk
hubris - ˈhjuːbrɪs
ruse - ruːz
mermaid - ˈmɜːmeɪd
benevolence - bəˈnevələns
harangue - həˈræŋ
nosey - ˈnəʊzi
iniquity - ɪˈnɪkwəti
linger - ˈlɪŋɡə(r)
predicament - prɪˈdɪkəmənt
vindictive - vɪnˈdɪktɪv
sabbath - ˈsæbəθ
piecemeal - ˈpiːsmiːl
weasel - ˈwiːzl
adhesive - ədˈhiːsɪv
payroll - ˈpeɪrəʊl
nab - næb
temerity - təˈmerəti
rural - ˈrʊərəl
insinuate - ɪnˈsɪnjueɪt
cemetery - ˈsemətri
conviviality - kənˌvɪviˈæləti
to crow - None
iffy - ˈɪfi
invigorate - ɪnˈvɪɡəreɪt
knuckle - ˈnʌkl
nibble - ˈnɪbl
nosh - nɒʃ
tenacity - təˈnæsəti
lodging - ˈlɒdʒɪŋ
havoc - ˈhævək
infiltrate - ˈɪnfɪltreɪt
mercenary - ˈmɜːsənəri
auspicious - ɔːˈspɪʃəs
conducive - kənˈdjuːsɪv
fad - fæd
perp - pɜːp
shiver - ˈʃɪvə(r)
canine - ˈkeɪnaɪn
drat - dræt
pituitary - pɪˈtjuːɪtəri
pun - pʌn
incline - ɪnˈklaɪn
dent - dent
treadmill - ˈtredmɪl
revamp - ˌriːˈvæmp
clause - klɔːz
squander - ˈskwɒndə(r)
crevasse - krəˈvæs
chintzy - ˈtʃɪntsi
rubbernecker - ˈrʌbənekə(r)
reside - rɪˈzaɪd
coagulate - kəʊˈæɡjuleɪt
long-winded - ˌlɒŋ ˈwɪndɪd
snot - snɒt
attenuate - əˈtenjueɪt
infraction - ɪnˈfrækʃn
pinch - pɪntʃ
myopic - maɪˈɒpɪk
clutter - ˈklʌtə(r)
chime in - None
carpenter - ˈkɑːpəntə(r)
contrive - kənˈtraɪv
wail - weɪl
instantiate - None
contiguous - kənˈtɪɡjuəs
broadly - ˈbrɔːdli
locket - ˈlɒkɪt
trample - ˈtræmpl
rile up - None
confine - kənˈfaɪn
coop - kuːp
sentient - ˈsentiənt
succinct - səkˈsɪŋkt
indigenous - ɪnˈdɪdʒənəs
pitfall - ˈpɪtfɔːl
revere - rɪˈvɪə(r)
impend - None
motley - ˈmɒtli
pied piper - None
feign - feɪn
consternation - ˌkɒnstəˈneɪʃn
inflatable - ɪnˈfleɪtəbl
proximity - prɒkˈsɪməti
opulence - ˈɒpjələns
gloss - ɡlɒs
vowel - ˈvaʊəl
grimy - ˈɡraɪmi
tantalize - None
wadding - ˈwɒdɪŋ
insulation - ˌɪnsjuˈleɪʃn
splinter - ˈsplɪntə(r)
kerfuffle - kəˈfʌfl
carnivore - ˈkɑːnɪvɔː(r)
rut - rʌt
precursor - priˈkɜːsə(r)
solicite - None
logger - ˈlɒɡə(r)
precarious - prɪˈkeəriəs
hodgepodge - ˈhɒdʒpɒdʒ
distaste - dɪsˈteɪst
scoff - skɒf
limb - lɪm
cuddle - ˈkʌdl
snooze - snuːz
a slew - None
forsake - fəˈseɪk
insatiable - ɪnˈseɪʃəbl
contradiction - ˌkɒntrəˈdɪkʃn
proprietary - prəˈpraɪətri
mindset - ˈmaɪndset
savvy - ˈsævi
bail - beɪl
bluntly - ˈblʌntli
adjourn - əˈdʒɜːn
dibs - dɪbz
banger - ˈbæŋə(r)
haul - hɔːl
expend - ɪkˈspend
proverb - ˈprɒvɜːb
entrepreneur - ˌɒntrəprəˈnɜː(r)
sprain - spreɪn
fillet - ˈfɪlɪt
inconsolable - ˌɪnkənˈsəʊləbl
stall - stɔːl
inn - ɪn
treatise - ˈtriːtɪs
concussion - kənˈkʌʃn
terse - tɜːs
bud - bʌd
nip - nɪp
rag - ræɡ
percolate - ˈpɜːkəleɪt
swerve - swɜːv
morbid - ˈmɔːbɪd
complement - ˈkɒmplɪment
judicious - dʒuˈdɪʃəs
infancy - ˈɪnfənsi
mold - məʊld
synthesize - ˈsɪnθəsaɪz
archenemy - None
incur - ɪnˈkɜː(r)
bog - bɒɡ
trait - treɪt
ensue - ɪnˈsjuː
conversely - ˈkɒnvɜːsli
snub - snʌb
convey - kənˈveɪ
inherent - ɪnˈherənt
tersely - ˈtɜːsli
reinforce - ˌriːɪnˈfɔːs
parentheses - None
tardy - ˈtɑːdi
wimp - wɪmp
manure - məˈnjʊə(r)
sentinel - ˈsentɪnl
exorbitant - ɪɡˈzɔːbɪtənt
boon - buːn
ravine - rəˈviːn
conscience - ˈkɒnʃəns
amenable - əˈmiːnəbl
devise - dɪˈvaɪz
omnipotent - ɒmˈnɪpətənt
colloquially - kəˈləʊkwiəli
connoisseur - ˌkɒnəˈsɜː(r)
onerous - ˈəʊnərəs
refinement - rɪˈfaɪnmənt
stringent - ˈstrɪndʒənt
bewildering - bɪˈwɪldərɪŋ
affix - əˈfɪks
unanimous - juˈnænɪməs
salvage - ˈsælvɪdʒ
gutter - ˈɡʌtə(r)
torrent - ˈtɒrənt
yeast - jiːst
bliss - blɪs
immersion - ɪˈmɜːʃn
daisy - ˈdeɪzi
consonant - ˈkɒnsənənt
prematurely - ˌpreməˈtʃʊəli
dilute - daɪˈluːt
numskull - ˈnʌmskʌl
amorous - ˈæmərəs
crook - krʊk
palanquin - None
revel - ˈrevl
opt out - None
cohesive - kəʊˈhiːsɪv
interoperate - None
crack open - None
slack - slæk
dire - ˈdaɪə(r)
debacle - dɪˈbɑːkl
tardiness - ˈtɑːdinəs
congenial - kənˈdʒiːniəl
crock - krɒk
